93
40
42 0 0 0 0 0 0 0 0 0 0 0 0 0 0 0 0 0 0 0 0 0 0 0 0 0 0 0 0 0 0 0 0 0 0 0 0 0 0 0 0 0 52 0 0 0 0 0 0 0 0 0 0 0 0 0 0 0 0 0 0 0 0 0 0 0 0 0 0 0 0 0 0 0 0 0 0 0 0 0 0 0 0 0 0 0 0 0 0 0 0 0 0 
42 0 0 0 0 0 0 0 0 0 0 0 0 0 0 0 0 0 0 0 0 0 0 0 0 0 0 0 0 0 0 0 0 0 0 0 0 0 0 0 0 0 52 0 0 0 0 0 0 0 0 0 0 0 0 0 0 0 0 0 0 0 0 0 0 0 0 0 0 0 0 0 0 0 0 0 0 0 0 0 0 0 0 0 0 0 0 0 0 0 0 0 0 
42 0 0 0 0 0 0 0 0 0 0 0 0 0 0 0 0 0 0 0 0 0 0 0 0 0 0 0 0 0 0 0 0 0 0 0 0 0 0 0 0 0 52 0 0 0 0 0 0 0 0 0 0 0 0 0 0 0 0 0 0 0 0 0 0 0 0 0 0 0 0 0 0 0 0 0 0 0 0 0 0 0 0 0 0 0 42 42 42 42 42 42 42 
42 0 0 0 0 0 0 0 0 42 0 0 0 0 0 0 0 0 0 0 0 0 0 0 0 0 0 0 0 0 0 0 0 0 0 0 0 0 0 0 0 0 52 0 0 0 0 0 0 0 0 0 0 0 0 0 0 0 0 0 0 0 0 0 0 0 0 0 0 0 0 16 0 0 0 0 0 0 0 0 0 0 0 0 0 0 42 17 17 18 17 17 42 
42 42 42 0 0 0 0 0 0 42 0 0 0 0 0 0 0 0 0 0 0 0 0 0 0 0 0 0 0 0 0 0 0 0 0 0 0 0 0 0 0 0 52 0 0 0 0 0 0 0 0 0 0 0 0 0 0 0 0 0 0 0 19 23 11 0 0 0 0 0 21 15 10 0 0 0 0 0 19 23 23 11 0 0 0 0 42 18 17 17 17 18 42 
42 0 46 0 0 0 0 0 0 42 0 0 0 0 0 0 0 0 0 0 0 0 0 0 0 0 0 0 0 0 0 0 0 0 0 0 0 0 0 0 0 0 52 0 0 0 0 0 0 0 0 0 0 0 9 0 0 9 0 0 0 0 23 14 23 0 9 0 0 0 15 15 15 0 0 0 0 0 23 14 14 23 9 0 0 0 2 15 15 15 15 15 42 
42 0 0 45 45 45 45 0 0 42 0 0 0 0 0 0 0 0 0 0 0 0 0 0 0 0 0 0 0 0 0 0 0 0 0 0 0 0 0 0 0 0 52 0 0 0 0 0 0 0 0 0 53 0 6 0 3 6 0 0 0 5 23 23 23 0 6 0 0 0 15 15 15 0 0 5 0 0 23 23 23 23 6 0 53 0 1 15 15 15 15 15 42 
42 42 42 42 42 0 0 0 0 42 0 0 0 0 0 0 0 0 0 0 0 0 0 0 0 0 52 52 52 52 52 52 52 52 52 52 52 52 52 52 52 52 52 0 0 0 0 0 0 40 40 40 40 40 40 40 40 40 40 40 40 40 40 40 40 40 40 40 40 40 40 40 40 40 40 40 40 40 40 40 40 40 40 40 40 40 40 40 40 40 40 40 40 
42 15 15 15 25 0 0 0 0 42 0 0 0 0 0 0 0 0 0 0 0 0 0 0 0 0 52 15 15 15 15 15 15 15 37 37 37 37 37 37 15 15 25 0 0 0 0 0 40 40 40 40 40 40 40 40 40 40 40 40 40 40 40 40 40 40 40 40 40 40 40 40 40 40 40 40 40 40 40 40 40 40 40 40 40 40 40 40 40 40 40 40 40 
42 57 15 15 24 0 0 0 0 42 0 0 0 0 0 0 0 0 0 0 0 0 0 0 0 0 52 13 13 15 15 15 15 15 37 37 37 37 37 37 15 15 24 0 0 0 0 40 40 40 40 40 40 40 40 40 40 40 40 40 40 40 40 40 40 40 40 40 40 40 40 40 40 40 40 40 40 40 40 40 40 40 40 40 40 40 40 40 40 40 40 40 40 
42 42 42 42 42 42 0 0 42 42 0 0 0 0 0 0 0 0 0 0 0 0 0 0 0 0 52 37 37 15 15 15 15 15 13 13 13 13 13 13 15 15 24 0 0 0 40 40 40 40 40 40 40 40 40 40 40 40 40 40 40 40 40 40 40 40 40 40 40 40 40 40 40 40 40 40 40 40 40 40 40 40 40 40 40 40 40 40 40 40 40 40 40 
42 0 0 0 0 0 0 0 0 42 0 0 0 0 0 0 0 0 0 0 0 0 0 0 0 0 52 37 37 15 15 15 15 15 52 52 52 52 52 52 52 52 52 40 40 40 40 40 40 40 40 40 40 40 40 40 40 40 40 40 40 40 40 40 40 40 40 40 40 40 40 40 40 40 40 40 40 40 40 40 40 40 40 40 40 40 40 40 40 40 40 40 40 
42 0 0 0 0 0 0 0 0 42 0 0 0 0 0 0 0 0 0 0 0 0 0 0 0 0 52 37 37 15 15 15 52 52 35 35 35 35 35 35 15 15 15 15 15 15 15 15 15 15 52 15 15 15 15 15 15 15 15 0 0 0 0 0 0 0 0 0 0 0 0 0 0 0 0 0 0 0 0 0 0 0 0 0 0 0 0 0 0 0 0 0 0 
42 42 42 42 42 42 42 0 0 42 0 0 0 0 0 0 0 0 0 0 0 0 0 0 0 0 52 37 37 15 15 15 15 15 35 35 35 35 35 35 15 15 15 15 15 13 13 13 13 13 52 15 15 15 15 15 15 15 15 0 0 0 0 0 0 0 0 0 0 0 0 0 0 0 0 0 0 0 0 0 0 0 0 0 0 0 0 0 0 0 0 0 0 
42 0 0 0 0 0 0 0 0 42 0 0 0 0 0 0 0 0 0 0 0 0 0 0 0 0 52 13 13 52 15 15 15 15 13 13 13 13 13 13 52 15 15 15 15 37 37 37 37 37 52 15 15 15 15 15 15 15 15 0 0 0 0 0 0 0 0 0 0 0 0 0 0 0 0 0 0 0 0 0 0 0 0 0 0 0 0 0 0 0 0 0 0 
42 0 0 0 0 0 0 0 0 42 0 0 0 0 0 0 0 0 0 0 0 0 0 0 0 0 52 52 52 52 52 52 52 52 52 52 52 52 52 52 52 15 15 15 15 37 37 37 37 37 52 15 15 15 15 15 15 15 15 0 0 0 0 0 0 0 0 0 0 0 0 0 0 0 0 0 0 0 0 0 0 0 0 0 0 0 0 0 0 0 0 0 0 
42 0 0 42 42 42 42 42 42 42 0 0 0 42 0 0 0 0 0 0 0 0 0 0 0 0 52 15 15 15 15 15 15 15 15 15 15 15 15 15 15 52 15 15 15 35 35 35 35 35 52 15 15 15 15 15 15 15 15 0 0 0 0 0 0 0 0 0 0 0 0 0 0 0 0 0 0 0 0 0 0 0 0 0 0 0 0 0 0 0 0 0 0 
42 0 0 0 0 0 0 0 0 42 0 0 0 42 0 0 0 0 0 0 0 0 0 0 0 0 52 15 15 15 15 13 13 13 15 15 15 15 15 15 15 15 15 15 15 35 35 35 35 35 52 15 15 15 15 15 15 15 15 0 0 0 0 0 0 0 0 0 0 0 0 0 0 0 0 0 0 0 0 0 0 0 0 0 0 0 0 0 0 0 0 0 0 
42 0 0 0 0 0 0 0 0 42 0 0 0 42 0 0 0 0 0 0 0 0 0 0 0 0 52 15 15 15 15 33 33 33 15 15 15 15 52 15 15 15 15 15 52 13 13 13 13 13 52 15 15 15 15 15 15 15 15 0 15 0 0 0 0 0 0 0 0 0 0 0 0 0 0 0 0 0 0 0 0 0 0 0 0 0 0 0 0 0 0 0 0 
42 42 42 0 0 0 0 0 0 42 0 0 0 42 0 0 0 0 0 0 0 0 0 0 0 0 52 15 15 15 15 33 33 33 15 15 15 15 52 52 52 52 52 52 52 52 52 52 52 52 52 15 15 15 15 15 15 15 15 0 15 0 0 0 0 0 0 0 0 0 0 0 0 0 0 0 0 0 0 0 0 0 0 0 0 0 0 0 0 0 0 0 0 
42 42 42 42 0 0 0 0 0 0 0 0 0 42 0 0 0 0 0 0 0 0 0 0 0 0 52 15 15 15 15 33 33 33 15 15 15 52 52 13 13 13 31 31 13 13 31 13 13 13 52 15 15 15 15 15 15 15 15 0 15 0 0 0 0 0 0 0 0 0 0 0 0 0 0 0 0 0 0 0 0 0 0 0 0 0 0 0 0 0 0 0 0 
42 42 42 42 42 0 0 0 0 0 0 0 0 42 0 0 0 0 0 0 0 0 0 0 0 0 52 15 15 15 15 33 33 33 15 15 15 15 15 31 31 13 31 13 31 13 31 13 13 39 52 15 15 15 15 15 15 15 15 0 15 0 0 0 0 0 0 0 0 0 0 0 0 0 0 0 0 0 0 0 0 0 0 0 0 0 0 0 0 0 0 0 0 
42 42 42 42 42 42 0 0 0 0 0 0 0 42 0 0 0 0 0 0 0 0 0 0 0 0 52 15 15 15 15 13 13 13 52 15 15 15 15 13 13 13 13 13 13 13 13 13 13 13 52 15 15 15 15 15 15 15 15 0 15 0 0 0 0 0 0 0 0 0 0 0 0 0 0 0 0 0 0 0 0 0 0 0 0 0 0 0 0 0 0 0 0 
42 42 42 42 42 42 42 42 42 42 0 0 0 42 0 0 0 0 0 0 0 0 0 0 0 0 52 15 15 15 15 52 52 52 52 52 52 52 52 52 52 52 52 52 52 52 52 52 52 52 52 15 15 15 15 15 15 15 15 0 15 0 0 0 0 0 0 0 0 0 0 0 0 0 0 0 0 0 0 0 0 0 0 0 0 0 0 0 0 0 0 0 0 
42 15 15 15 15 15 15 15 25 0 0 0 0 42 0 0 0 0 0 0 0 0 0 0 0 0 52 15 15 15 15 33 33 33 33 33 33 33 15 15 15 15 15 15 15 15 15 15 15 15 52 15 15 15 15 15 15 15 15 0 15 0 0 0 0 0 0 0 0 0 0 0 0 0 0 0 0 0 0 0 0 0 0 0 0 0 0 0 0 0 0 0 0 
42 15 15 15 15 15 15 15 24 0 0 0 0 42 0 0 0 0 0 0 0 0 0 0 0 0 52 52 15 15 15 33 33 33 33 33 33 33 15 15 15 15 15 13 13 13 13 13 13 13 52 15 15 15 15 15 15 15 15 0 15 0 0 0 0 0 0 0 0 0 0 0 0 0 0 0 0 0 0 0 0 0 0 0 0 0 0 0 0 0 0 0 0 
42 15 15 15 15 15 42 42 42 42 42 42 42 42 0 0 0 0 0 0 0 0 0 0 0 0 52 52 15 15 15 13 13 13 13 13 13 13 52 15 15 15 15 26 26 26 26 26 26 26 52 15 15 15 15 15 15 15 15 0 15 0 0 0 0 0 0 0 0 0 0 0 0 0 0 0 0 0 0 0 0 0 0 0 0 0 0 0 0 0 0 0 0 
42 15 15 15 15 42 15 15 42 0 0 0 0 0 0 0 0 0 0 0 0 0 0 0 0 0 52 52 52 52 52 52 52 52 52 52 52 52 52 15 15 15 15 26 26 26 26 26 26 26 52 15 15 15 15 15 15 15 15 0 15 0 0 0 0 0 0 0 0 0 0 0 0 0 0 0 0 0 0 0 0 0 0 0 0 0 0 0 0 0 0 0 0 
42 15 15 42 42 15 15 15 42 0 0 0 0 0 0 0 0 0 0 0 0 0 0 0 0 0 2 15 15 15 15 26 26 26 26 26 26 26 52 52 15 15 15 26 26 26 26 26 26 26 52 15 15 15 15 15 15 15 15 0 15 0 0 0 0 0 0 0 0 0 0 0 0 0 0 0 0 0 0 0 0 0 0 0 0 0 0 0 0 0 0 0 0 
42 15 15 15 15 15 15 15 25 0 0 0 0 7 0 0 0 7 0 0 0 7 0 0 0 0 1 15 15 15 15 26 26 26 26 26 26 26 15 15 15 15 15 26 26 26 26 26 26 26 52 15 15 15 15 15 15 15 15 0 0 0 0 0 0 0 0 0 0 0 0 0 0 0 0 0 0 0 0 0 0 0 0 0 0 0 0 0 0 0 0 0 0 
42 15 15 15 15 15 15 15 24 0 0 0 0 6 0 0 0 6 0 0 0 6 0 53 0 0 1 15 15 15 15 13 13 13 13 13 13 13 15 15 15 15 52 13 13 13 13 13 13 13 52 15 15 15 15 15 15 15 15 0 0 0 0 0 0 0 0 0 0 0 0 0 0 0 0 0 0 0 0 0 0 0 0 0 0 0 0 0 0 0 0 0 0 
40 40 40 40 40 40 40 40 40 40 51 51 51 51 51 51 51 51 51 51 51 51 51 51 51 40 40 15 15 15 52 52 52 52 52 52 52 52 52 52 52 52 52 52 52 52 52 52 52 52 52 15 15 15 15 15 15 15 15 0 0 0 0 0 0 0 0 0 0 0 0 0 0 0 0 0 0 0 0 0 0 0 0 0 0 0 0 0 0 0 0 0 0 
40 40 40 40 40 40 40 40 40 40 51 51 51 51 51 51 51 51 51 51 51 51 51 51 51 40 52 15 15 15 15 15 15 15 15 15 15 15 15 15 15 15 15 15 15 15 15 15 15 15 52 15 15 15 15 15 15 15 15 15 15 15 15 0 0 0 0 0 0 0 0 0 0 0 0 0 0 0 0 0 0 0 0 0 0 0 0 0 0 0 0 0 0 
40 40 40 40 40 40 40 40 40 40 51 51 51 51 51 51 51 51 51 51 51 51 51 51 51 40 52 52 15 15 15 15 15 15 15 15 15 15 15 15 15 15 15 15 15 15 15 15 15 15 52 15 15 15 15 15 15 15 15 15 15 15 15 0 0 0 0 0 0 0 0 0 0 0 0 0 0 0 0 0 0 0 0 0 0 0 0 0 0 0 0 0 0 
40 40 40 40 40 40 40 40 40 40 51 51 51 51 51 51 51 51 51 51 51 51 51 51 51 40 52 52 52 52 52 52 52 52 52 52 52 52 15 15 15 15 15 13 13 13 13 13 13 13 52 15 15 15 15 15 15 15 15 15 15 0 0 0 0 0 0 0 0 0 0 0 0 0 0 0 0 0 0 0 0 0 0 0 0 0 0 0 0 0 0 0 0 
0 0 0 0 0 0 0 0 0 0 0 0 0 0 0 0 51 51 51 51 51 51 51 51 51 40 52 17 17 17 17 17 17 17 17 17 17 17 52 15 15 15 15 29 29 29 29 29 29 29 52 15 15 15 15 15 15 15 15 15 0 0 0 0 0 0 0 0 0 0 0 0 0 0 0 0 0 0 0 0 0 0 0 0 0 0 0 0 0 0 0 0 0 
0 0 0 0 0 0 0 0 0 0 0 0 0 0 0 0 51 51 51 51 51 51 51 51 51 40 52 29 29 29 29 29 29 29 29 29 29 29 15 52 15 15 15 29 29 29 29 29 29 29 52 15 15 15 15 15 15 15 15 15 0 0 0 0 0 0 0 0 0 0 0 0 0 0 0 0 0 0 0 0 0 0 0 0 0 0 0 0 0 0 0 0 0 
0 0 0 0 0 0 0 0 0 0 0 0 0 0 0 0 51 51 51 51 51 51 51 51 51 40 52 57 29 29 29 29 29 29 29 29 29 29 15 15 15 15 15 29 29 29 29 29 29 29 52 15 15 15 15 15 15 15 15 15 0 0 0 0 0 0 0 0 0 0 0 0 0 0 0 0 0 0 0 0 0 0 0 0 0 0 0 0 0 0 0 0 0 
0 0 0 0 0 0 0 0 0 0 0 0 0 0 0 0 51 51 51 51 51 51 51 51 51 40 52 13 13 13 13 13 13 13 13 13 13 13 15 15 15 15 52 13 13 13 13 13 13 13 52 15 15 15 15 15 15 15 15 15 0 0 0 0 0 0 0 0 0 0 0 0 0 0 0 0 0 0 0 0 0 0 0 0 0 0 0 0 0 0 0 0 0 
0 0 0 0 0 0 0 0 0 0 0 0 0 0 0 0 51 51 51 51 51 51 51 51 51 40 52 52 52 52 52 52 52 52 52 52 52 52 52 52 52 52 52 52 52 52 52 52 52 52 52 15 15 15 15 15 15 15 15 0 0 0 0 0 0 0 0 0 0 0 0 0 0 0 0 0 0 0 0 0 0 0 0 0 0 0 0 0 0 0 0 0 0 
