92
8
0 0 0 0 0 0 0 0 0 0 0 0 0 0 0 0 0 0 0 0 0 0 0 0 0 0 0 0 0 0 0 0 0 0 0 0 0 0 0 0 0 0 0 0 0 0 0 0 0 0 0 0 0 0 0 0 0 0 0 0 0 0 0 0 0 0 0 0 0 0 0 0 0 0 0 0 0 0 0 0 0 0 0 0 0 0 0 0 0 0 0 0 
0 0 0 0 0 0 0 0 0 0 0 0 0 0 0 0 0 0 0 0 0 0 0 0 0 0 0 0 0 0 0 0 0 0 0 0 0 0 0 0 0 0 0 0 0 0 0 0 0 0 0 0 0 0 0 0 0 0 0 0 0 0 0 0 0 0 0 0 0 0 0 0 0 0 0 0 0 0 0 0 0 0 0 0 0 0 0 0 0 0 0 0 
42 42 42 42 42 42 42 0 0 0 0 0 0 0 0 0 0 0 0 0 0 0 0 0 0 0 0 0 0 0 0 0 0 0 0 0 0 0 0 0 0 0 0 0 0 0 0 0 0 0 0 0 0 0 0 0 0 0 0 0 0 0 0 0 0 0 0 0 0 0 0 0 0 0 0 0 0 0 0 0 0 0 0 0 52 52 52 52 52 52 52 52 
42 17 17 18 17 17 42 0 0 0 0 0 0 0 0 0 0 0 0 0 0 0 0 0 0 0 0 0 0 0 0 0 0 0 0 0 0 0 0 0 0 0 0 0 0 0 0 19 23 23 23 23 23 23 23 11 0 0 0 0 0 0 0 0 0 0 0 0 0 0 0 0 0 0 0 0 0 0 0 0 0 0 0 0 52 12 14 12 12 14 12 52 
42 18 17 17 17 18 42 0 0 0 0 0 0 0 0 0 0 0 0 0 0 0 19 23 11 0 0 0 0 0 0 0 0 16 0 0 0 0 0 0 0 0 0 0 0 0 0 4 30 0 36 0 36 0 34 4 0 0 0 0 0 0 0 0 0 0 19 23 23 11 0 0 0 0 0 0 0 0 0 0 0 0 0 0 52 12 14 12 12 14 12 52 
42 15 15 15 15 15 25 0 0 0 0 9 0 0 9 0 0 0 0 7 0 0 4 32 4 0 0 0 7 0 0 7 21 15 10 0 7 0 0 0 7 0 0 7 0 0 0 4 20 0 20 0 20 0 20 4 0 0 0 0 7 0 0 0 8 0 23 14 14 23 0 0 0 8 0 0 0 8 0 0 0 8 0 0 2 23 23 23 23 23 23 52 
42 15 15 15 15 15 24 0 5 0 0 6 0 53 6 0 0 0 3 6 0 0 20 20 20 0 0 0 6 0 0 6 15 15 15 0 6 0 0 0 6 0 0 6 0 0 0 20 20 20 20 20 20 20 20 20 0 0 3 0 6 53 0 0 6 0 23 23 23 23 5 0 0 6 0 40 0 6 0 0 0 6 5 0 1 23 23 23 23 23 23 52 
40 40 40 40 40 40 40 40 40 40 40 40 40 40 40 40 40 40 40 51 51 51 51 51 51 51 51 51 51 51 51 51 51 51 51 51 51 51 51 51 51 51 51 51 51 51 51 51 51 51 51 51 51 51 51 51 51 51 51 51 51 40 40 40 40 40 40 40 40 40 40 40 40 40 40 40 40 40 40 40 40 40 40 40 40 40 40 40 40 40 40 40 
