236
8
0 0 0 0 0 0 0 0 0 0 0 0 0 0 0 0 0 0 0 0 0 0 0 0 0 0 0 0 0 0 0 0 0 0 0 0 0 0 0 0 0 0 0 0 0 0 0 0 42 42 42 42 42 42 42 42 42 42 42 42 42 42 42 42 42 42 42 42 42 42 42 42 42 42 42 42 42 42 42 42 42 42 0 0 0 0 0 0 0 0 0 0 0 0 0 0 0 0 0 0 0 0 0 0 0 0 0 0 0 0 0 0 0 0 0 0 0 0 0 0 0 0 0 0 0 0 0 0 0 0 0 0 0 0 0 0 0 0 0 0 0 0 0 0 0 0 0 0 0 0 0 0 0 0 0 0 0 0 0 0 0 0 0 0 0 0 0 0 0 0 0 0 0 0 0 0 0 0 0 0 0 0 0 19 23 23 23 23 23 23 23 23 23 23 23 11 0 0 0 0 0 0 0 0 0 0 0 0 0 0 0 0 0 0 0 0 0 0 0 0 0 0 0 0 0 0 0 0 0 0 0 0 0 0 0 0 
0 0 0 0 0 0 0 0 0 0 0 0 0 0 0 0 0 0 0 0 0 0 0 0 0 0 0 0 0 0 0 0 0 0 0 0 0 0 0 0 0 0 0 0 0 0 0 0 42 17 17 18 18 17 18 17 17 17 18 18 17 17 18 18 17 17 18 18 17 17 18 18 17 17 17 18 17 18 18 17 17 42 0 0 0 0 0 0 0 0 0 0 0 0 0 0 0 0 0 0 0 0 0 0 0 0 0 0 0 0 0 0 0 0 0 0 0 0 0 0 0 0 0 0 0 0 0 0 0 0 0 0 0 0 0 0 0 0 0 0 0 0 0 0 0 0 0 0 0 0 0 0 0 0 0 0 0 0 0 0 0 0 0 0 0 0 0 0 0 0 0 0 0 0 0 0 0 0 0 0 0 0 0 4 0 0 36 0 0 4 0 0 36 0 0 4 0 0 0 0 0 0 0 0 0 0 0 0 0 0 0 0 0 0 0 0 0 0 0 0 0 0 0 0 0 0 0 0 0 0 0 0 0 0 0 0 
42 42 42 42 42 42 42 0 0 0 0 0 0 0 0 0 0 0 0 0 0 0 0 0 0 0 0 0 0 0 0 0 0 0 0 0 0 0 0 0 0 0 0 0 0 0 0 0 42 17 17 18 18 15 15 15 15 15 15 15 15 15 22 22 15 22 22 15 15 15 22 15 22 15 22 15 15 18 18 17 17 42 0 0 0 0 0 0 0 0 0 0 0 0 0 0 0 0 0 0 0 0 0 0 0 0 0 0 0 0 0 0 0 9 0 0 0 0 0 0 0 0 0 0 0 0 0 0 0 0 0 0 0 0 0 0 0 0 0 0 0 0 0 0 0 0 0 0 0 0 0 0 0 0 0 0 0 0 0 0 0 0 0 0 0 0 0 0 0 0 0 0 0 0 0 0 0 0 0 0 0 0 9 4 27 27 20 32 32 4 32 32 20 34 34 4 8 0 0 0 0 0 0 0 0 0 0 0 0 0 0 0 0 0 0 0 0 0 0 0 0 0 0 0 0 0 0 0 0 0 0 0 0 0 0 52 
42 17 17 18 17 17 42 0 0 0 0 0 0 0 0 0 0 0 0 0 0 0 0 0 0 0 0 0 0 0 0 0 0 0 0 0 0 0 0 0 0 0 0 0 0 0 0 0 42 15 15 15 15 15 15 15 15 15 15 15 15 15 22 22 15 22 22 15 15 43 43 43 43 43 43 43 15 15 15 15 15 42 0 0 0 0 0 0 0 0 0 0 0 0 0 0 0 0 0 0 0 0 0 0 0 19 23 23 23 23 23 23 23 23 0 0 0 0 0 0 40 45 0 0 0 45 0 0 45 0 45 40 0 0 0 0 0 0 0 0 0 0 0 0 0 0 0 0 0 0 0 0 0 0 0 0 0 0 0 0 0 0 0 0 0 0 0 0 0 0 0 0 0 0 0 0 0 0 0 0 0 0 6 20 20 20 20 20 20 20 20 20 20 20 20 20 6 0 0 0 0 0 0 0 0 0 0 0 0 0 0 0 0 0 0 0 0 0 0 0 0 0 0 0 0 0 0 0 0 0 0 0 0 0 0 52 
42 18 17 17 17 18 42 0 0 0 0 0 0 0 0 0 0 0 0 0 0 0 0 0 0 0 19 23 23 11 0 0 0 0 0 0 19 23 23 11 0 0 0 0 0 0 0 0 2 15 15 15 15 15 15 15 15 15 15 15 43 43 43 43 43 43 43 43 43 43 15 15 15 15 15 43 43 43 43 15 15 25 0 0 0 0 0 0 0 0 16 0 0 0 0 0 0 19 23 23 11 0 0 0 0 23 14 14 23 14 14 23 14 14 0 0 0 0 0 0 40 0 0 0 0 0 0 0 0 0 0 0 40 0 0 0 0 40 45 0 0 45 0 0 0 0 0 0 0 0 0 0 0 0 0 0 0 0 0 0 0 0 0 19 11 0 0 0 0 0 0 0 0 0 0 0 0 0 0 0 0 0 40 40 40 40 40 40 40 40 40 40 40 40 40 40 40 0 0 0 0 0 0 0 0 0 0 0 19 23 23 23 11 0 0 0 19 23 23 11 0 0 0 0 0 0 0 0 0 0 0 0 0 0 0 52 
42 15 15 15 15 15 25 0 0 0 8 0 0 8 0 0 8 0 0 7 0 27 27 0 7 0 4 30 30 4 0 7 0 32 0 7 4 27 27 4 7 0 0 0 9 0 0 0 1 15 15 15 15 15 15 15 15 15 15 43 15 15 15 15 15 15 15 15 15 15 15 22 22 15 15 15 15 15 15 15 15 24 0 0 0 8 0 0 0 15 15 15 0 0 8 0 0 23 14 14 23 0 8 0 0 23 23 23 23 23 23 23 23 23 0 0 0 8 0 40 40 0 7 0 0 0 7 0 0 0 7 0 0 0 0 0 40 40 7 0 0 7 0 0 0 7 0 0 0 8 0 0 0 8 0 0 0 8 0 0 0 0 0 23 14 0 0 0 0 7 0 27 27 0 7 0 32 0 7 0 0 40 40 40 40 40 40 40 40 40 40 40 40 40 40 40 40 40 0 0 0 0 7 0 0 32 0 7 4 0 32 32 4 0 7 0 4 34 34 4 0 7 0 0 0 7 0 0 7 0 0 0 9 0 0 52 
42 15 15 15 15 15 24 0 5 53 6 0 3 6 0 0 6 0 0 6 0 20 20 0 6 0 20 20 20 20 0 6 0 20 0 6 4 20 20 4 6 0 0 0 6 0 5 0 1 15 15 22 15 22 15 22 15 15 43 15 15 22 15 22 15 22 15 22 15 15 15 22 22 15 15 22 15 22 15 15 15 24 0 0 53 6 0 0 3 15 15 15 0 3 6 0 5 23 23 23 23 0 6 0 0 23 23 23 23 23 23 23 23 23 0 5 5 6 40 40 40 0 6 0 0 0 6 0 0 0 6 0 0 0 0 40 40 40 6 0 0 6 0 0 0 6 0 0 0 6 53 3 0 6 0 0 0 6 0 3 0 0 0 23 23 0 0 0 0 6 0 20 20 0 6 0 20 0 6 0 40 40 40 40 40 40 40 40 40 40 40 40 40 40 40 40 40 40 40 0 0 0 6 0 0 20 0 6 4 20 20 20 20 0 6 0 4 20 20 20 0 6 0 0 0 6 0 0 6 53 0 0 6 5 0 52 
40 40 40 40 40 40 40 40 40 40 40 40 40 40 51 51 51 51 51 51 51 51 51 51 51 51 51 51 51 51 51 51 51 51 51 51 51 51 51 51 51 51 51 51 40 40 40 40 40 40 40 40 40 40 40 40 40 40 40 40 40 40 40 40 40 40 40 40 40 40 40 40 40 40 40 40 40 40 40 40 40 40 40 40 40 40 40 40 40 40 40 40 40 40 40 40 40 40 40 40 40 40 40 40 40 40 40 40 40 40 40 40 40 40 40 40 40 40 51 51 51 51 51 51 51 51 51 51 51 51 51 51 51 51 51 51 51 51 51 51 51 51 51 51 51 51 51 40 40 40 40 40 40 40 40 40 40 40 40 40 40 40 40 40 40 40 40 40 51 51 51 51 51 51 51 51 51 51 51 51 51 51 51 51 51 51 51 51 51 51 51 51 51 51 51 51 51 51 51 51 51 51 51 51 51 51 51 51 51 51 51 51 51 51 51 51 51 51 51 51 51 51 51 51 51 51 51 51 51 40 40 40 40 40 40 40 
